WWWWWW
WX0Q0W
W0000W
W0000W
W0000W
WWX00W
WWWWW
4,1
2,3
3,3