WWWWWW
W00WWW
W00X00
W00W00
WX0W0W
WW000W
WWWWWW
2,5
1,2
4,2