WWWWWWWW
WWWWW0XW
WWWWWW0W
WW00000W
0000XW0W
0000000W
W0W00WWW
W000WWWW
4,3
1,6
2,5