W00WWW
W0000W
WX000W
W0WW00
WX0000W
WWWWWW
2,4
2,1
4,2